1111111111111
10010000000C1
1000011111001
1PC011E010001
1111111111111
