1111111111111
100100000P0C1
1000011111001
1PC011E000001
1111111111111
